1111111111111111111111111111111111111
100P0000000000C00000001000000C00000E1
10000000000000C00000001000000C0000001
1000000000000000000000100000000000001
1000000000000000000000100000000000001
1000000000000000000000100000000000001
1011111111111111100000100000000000001
101000100000000C100000100000000000001
1010101000000000100000100000000000001
101010100C000000100000100000000000001
1000100000S00000100000000000000000001
1111111111111111111111111111111111111
