1111111111111111111111111111111111111
1P00000000000C0000000000000C0000000E1
1000000000000000000S000000000S0000001
10000000000000S0000000000C00000000001
1000000000000000000C00000000000000001
1111111111111111111111111111111111111
