1111111111111111111111111111111111111111111111111111111111
1000000000000000000000000000000000000000000000000000000001
1000000000000000000000000000000000000000000000000000000001
10000000000000000000C000000000C000000000000000000000000001
1000000000000000000000000000000000000000000000000000000001
1000001111111111111111111111111111111111111111111111000001
10000000000000000000000000P0000000000000000000000000000001
100000000000000000000000000000C000000000000000000000000001
1000001111111111111111111111111111111111111111111111000001
1000000000000000000000000000000000000000000000000000000001
10C00000000000000000000000000000000000000000000000000000E1
1111111111111111111111111111111111111111111111111111111111